############################
#                         #
#   #################  ##  #
# ######            ########
# #################### #####
#                      #####
##################### ######
#  ##                  #####
#  ##  ### ##B##############
#  ##  ### ####          ##
#      ################## ##
###       ##############  ##
########  ##############  ##
##A                       ##
############################ 