###############################
#A #       ##                 #
#  # ####     ######## ###  ###
#  # #  #  ##     ##          #
#  #    ####       #  ####### #
#  #    #  ### #####   ##     #
#  #               #        ###
# ###  # ##  ## #  #  #  ##   #
#   #  # ##  #  #  #  #  ###  #
# ###  #  #  ## #  #  ###  #  #
#     #   # ##   #    ##  #  ##
# ###  #  #    #  #  #  #  #  #
#  #  #  #  #  #  #  #  #  #  #
# ###  ####  #  ####  #  #   ##
#   #  #  #  ##  # #  #  #    #
# ###  # ###  #  # ##  # #  ###
#   #  # #  #  #   #  #  #  # #
# ###  #        #     #       #
#      ###   ##     ####  ### #
# ###      #  #   ###        B#
###############################