################
# A            #
#  #####  ######
#  #   #  #   ##
#  #   #  #   ##
#  #           #
#  #####  ######
#            B #
################