############################
#                          #
#   ###################   ##
# ####                # # ##
# ################### # # ##
#                     # # ##
##################### # # ##
#   ##                # # ##
# # ## ### ## ######### # ##
# #    #   ##B#         # ##
# # ## ################ # ##
### ##             #### # ##
### ############## ## # # ##
###             ##    # # ##
###### ######## ####### # ##
######  ####             # #
##A    #####################
############################