##################
# A              #
# ##### ##### ####
#                #
# ##### ##### ####
#  #           ###
## ## ### # ##   #
#  #    #        #
# ###     #   # ##
# # # # # ### # ##
# # # ### ###   ##
# # #   # ### ####
#     #        B #
##################