##################
# A              #
# ##### ##### ####
# #              #
# # ##### #####  #
# #   #       #  #
# ## ## ##### ## #
# #  #    ##  #  #
# # ###   ##  # ##
# # # # ##### # ##
#           #   B#
##################